做客	zuò kè	làm khách
甜	tián	ngọt
圣诞节	Shengdan Jié	Giáng Sinh
打扮	dǎbàn	ăn mặc,trang điểm
越来越	yuèláiyuè	ngày càng
越越	yuè...yuè	càng càng
新年	xīnnián	Năm mới
装饰	zhuāngshì	trang trí
打的	dǎ dí	bắt taxi
盖	gài	xây,che,đậy ,nắp,vung
随便	suíbiàn	tùy ý ,tuỳ tiện
礼物	lǐwù	quà tặng
空	kōng	trống
住宅	zhùzhái	nhà ở ,nơi ở
感想	gǎnxiǎng	cảm nghĩ,cảm nhận
欢乐	huānlè	vui vẻ,vui
四合院	sìhéyuàn	nhà tứ hợp
小区	xiǎoqū	khu dân cư
体会	tǐhuì	trải nghiệm
节日	jiérì	ngày lễ
院子	yuànzi	sân
建	jiàn	xây dựng
意见	yìjiàn	ý kiến
春节	Chūn Jié	Tết Nguyên Đán
种	zhòng	trồng
搬	bān	di chuyển
建议	jiànyì	đề xuất,kiến nghị ,khuyên
开	kāi	mở
棵	kē	cây
遗憾	yíhàn	tiếc nuối
提	tí	đề cập,vấn đề
联欢会	liánhuānhuì	liên hoan
枣	zǎo	táo tàu
舍不得	shěbùdé	không nỡ,tiếc thay
出门	chū mén	ra ngoài
结	jiē	kết,kết trái,kết quả
离开	líkāi	rời đi,rời xa
人们	rénmen	mọi người
现代化	xiàndàihuà	hiện đại hóa
丰富	fēngfù	phong phú
品尝	pǐncháng	nếm thử
打扫	dǎsǎo	dọn dẹp
夫人	fūren	phu nhân
可不是	kěbùshì	đúng vậy
特色	tèsè	đặc sắc
窗户	chuānghu	cửa sổ
幅	fú	bức
仔细	zǐxì	cẩn thận,kĩ tính
亲手	qīnshǒu	tự tay
窗	chuāng	cửa sổ
水仙	shuǐxiān	thủy tiên
认识	rènshi	quen biết
最好	zuìhǎo	tốt nhất
擦	cā	lau
声音	shēngyīn	âm thanh
把	bǎ	cái
桌子	zhuōzi	cái bàn
福	fú	phúc
椅子	yǐzi	ghế
它	tā	nó
圆圈	yuánquān	vòng tròn
字	zì	chữ
幸福	xìngfú	hạnh phúc
布置	bùzhì	bày trí
黑板	hēibǎn	bảng đen
对联	duìlián	câu đối
倒	dào	đổ
会场	huìchǎng	hội trường
音响	yīnxiǎng	giàn âm thanh
新春	xīnchūn	Tết mới
沙发	shāfā	ghế sofa
管理员	guǎnlǐyuán	quản lý viên
彩灯	cǎidēng	đèn màu
吉祥	jíxiáng	cát tường
冰箱	bīngxiāng	tủ lạnh
管理	guǎnlǐ	quản lý
彩带	cǎidài	dải màu
行业	hángyè	ngành nghề
洗衣机	xǐyījī	máy giặt
告诉	gàosu	nói với,thì thầm
兴旺	xīngwàng	thịnh vượng,hưng thịnh
空调	kōngtiáo	điều hòa
答应	dāying	đồng ý
宾馆	bīnguǎn	khách sạn
惊喜	jīngxǐ	bất ngờ, kinh ngạc vui mừng, ngạc nhiên mừng rỡ
国外	guówài	nước ngoài
安全	ānquán	an toàn
乘	chéng	đi
发	fā	phát ra
办理	bànlǐ	xử lý
响声	xiǎngshēng	tiếng vang
登机	dēng jī	lên máy bay
装	zhuāng	sắp xếp
手续	shǒuxù	thủ tục
硬币	yìngbì	tiền kim loại
行李	xíngli	hành lý
掏	tāo	móc
托运	tuōyùn	gửi vận chuyển
画报	huàbào	hoạ báo, báo ảnh, tạp chí ảnh
机票	jīpiào	vé máy bay
暗	àn	tối
票	piào	vé
开关	kāiguān	công tắc
登机牌	dēngjīpái	thẻ lên máy bay
扶手	fúshǒu	tay vịn
通过	tōngguò	thông qua
空姐	kōngjiě	tiếp viên hàng không
起飞	qǐfēi	cất cánh
系	jì	buộc
安全带	ānquándài	dây an toàn
带	dài	dây
卡子	qiǎzi	kẹp
扳	bān	bẻ
插头	chātóu	phích cắm
凉	liáng	mát
小心	xiǎoxīn	cẩn thận
杯子	bēizi	cốc
洒	sǎ	rơi
腿	tuǐ	chân
上街	shàng jiē	ra phố, lên phố
被	bèi	bị, được
撞	zhuàng	va, chạm, đụng
倒	dǎo	ngã, đổ
伤	shāng	tổn thương, bị thương
流	liú	chảy, di động
血	xiě	máu
要紧	yàojǐn	nghiêm trọng, quan trọng
不要紧	bù yàojǐn	không nghiêm trọng
骨头	gǔtou	xương
不好意思	bù hǎo yìsi	xấu hổ, ngại
故意	gùyì	cố tình
哎	āi	thán từ
钱包	qiánbāo	ví tiền
让	ràng	để, để cho
小偷	xiǎotōu	kẻ cắp
偷	tōu	trộm, cắp
遇到	yùdào	gặp phải
叫	jiào	gọi, kêu, bảo
淋	lín	thấm ướt, dầm
落汤鸡	luòtāngjī	ướt như chuột lột
似的	shìde	như, tựa như
湿	shī	ẩm, ướt
透	tòu	thấm, xuyên qua
首都	shǒudū	thủ đô
剧场	jùchǎng	kịch trường, nhà hát
司机	sījī	tài xế
拉	lā	lôi, kéo, đưa
机场	jīchǎng	sân bay
可气	kěqì	đáng giận
算命	suànmìng	bói toán
运气	yùnqì	vận mệnh, số phận
傻	shǎ	ngốc
花	huā	dùng thời gian, chi tiêu
受骗	shòu piàn	bị lừa
受	shòu	bị, chịu
骗	piàn	lừa gạt
抽烟	chōuyān	hút thuốc
罚	fá	phạt
烧	shāo	đốt, thiêu
戒烟	jièyān	cai thuốc lá
浪费	làngfèi	lãng phí
大山	Dàshān	Đại Sơn
演出	yǎnchū	diễn xuất, biểu diễn
猜	cāi	đoán
演员	yǎnyuán	diễn viên
武打	wǔdǎ	múa võ
动作	dòngzuò	động tác
精彩	jīngcǎi	đặc sắc
脸谱	liǎnpǔ	kiểu vẽ mặt, vẻ mặt
表现	biǎoxiàn	biểu hiện
人物	rénwù	nhân vật
社会	shèhuì	xã hội
地位	dìwèi	địa vị
性格	xìnggé	tính cách
十分	shífēn	rất, vô cùng
有趣	yǒuqù	thú vị, lí thú
服装	fúzhuāng	trang phục
影响	yǐngxiǎng	ảnh hưởng
传统	chuántǒng	truyền thống
艺术	yìshù	nghệ thuật
了解	liǎojiě	hiểu rõ, tìm hiểu
的话	dehuà	...dùng sau câu biểu thị giả thiết hẹn, mời
约	yuē	hẹn
了	liǎo	xong, rồi
决定	juédìng	quyết định
上下班	shàng xià bān	đi làm và tan làm
担心	dānxīn	lo lắng
肯定	kěndìng	khẳng định
排	pái	hàng, loạt, bảng
估计	gūjì	áng chừng, phỏng đoán
下	xià	xuống
开演	kāiyǎn	bắt đầu biểu diễn
满	mǎn	đầy
说明书	shuōmíngshū	bản thuyết minh/hướng dẫn sử dụng
说明	shuōmíng	thuyết minh
古代	gǔdài	cổ đại
神话	shénhuà	thần thoại
天上	tiānshàng	trên trời
仙女	xiānnǚ	tiên nữ
羡慕	xiànmù	ngưỡng mộ
人间	rénjiān	nhân gian, trần gian
偷偷	tōutōu	lén lút, vụng trộm
内容	nèiróng	nội dung
缆车	lǎnchē	xe cáp, cáp treo
喘气	chuǎn qì	thở dốc
动	dòng	di động, lay động
到底	dàodǐ	rốt cuộc
胜利	shènglì	thắng lợi
加油	jiāyóu	cố lên, cố gắng
出汗	chū hàn	ra mồ hôi
汗	hàn	mồ hôi
身	shēn	thân thể
接着	jiēzhe	tiếp tục, tiếp theo
危险	wēixiǎn	nguy hiểm
比	bǐ	so sánh, sánh
积极	jījí	tích cực
相声	xiàngsheng	tấu, tấu hài
台词	táicí	lời thoại
台背	bèi	học thuộc, công
话剧	huàjù	kịch nói
排练	páiliàn	tập
受伤	shòu shāng	bị thương
纠正	jiūzhèng	sửa chữa, uốn nắn
演	yǎn	diễn
只要就	zhǐyào...jiù...	chỉ cần ...
世上	shìshàng	ở đời, trên thế giới
无	wú	không có
怕	pà	sợ
心	xīn	tim, tư tưởng
自信	zìxìn	tự tin
相信	xiāngxìn	tin tưởng
争取	zhēngqǔ	tranh thủ
恐怕	kǒngpà	sợ rằng, có lẽ
首	shǒu	bài
突然	tūrán	đột nhiên
熟	shú	quen, biết, thông thạo
一下子	yíxiàzi	loáng một cái, thoáng qua
应	yīng	nhận
国际	guójì	quốc tế
广播	guǎngbò	phát thanh
电台	diàntái	đài
邀请	yāoqǐng	mời
呆	dāi	ở lại, lưu lại
签	qiān	ký
合同	hétóng	hợp đồng
中外	zhōng-wài	Trung Quốc và nước ngoài
合资	hézī	hợp tác đầu tư
空儿	kòngr	thời gian trống
地址	dìzhǐ	địa chỉ
业务	yèwù	nghiệp vụ
搞	gǎo	làm
交流	jiāoliú	giao lưu
成立	chénglì	thành lập
不久	bùjiǔ	không lâu
开展	kāizhǎn	mở ra, triển khai
继续	jìxù	tiếp tục
一定	yídìng	nhất định
基础	jīchǔ	cơ sở
只要...才...	zhǐyào...cái...	chỉ cần...mới...
光	guāng	nhẵn bóng, hết sạch
抽	chōu	rút
同意	tóngyì	đồng ý
海伦	Hǎilún	Hải Luân
民族	mínzú	dân tộc
风俗	fēngsú	phong tục
路线	lùxiàn	tuyến
一边...一边...	yìbiān...yìbiān...	vừa...vừa...
考察	kǎochá	khảo sát
公费	gōngfèi	công phí
碑林	Bēilín	Rừng bia
重庆	Chóngqìng	Trùng Khánh
长江	Cháng Jiāng	Trường Giang
三峡	Sānxiá	Tam Hiệp
苏州	Sūzhōu	Tô Châu
句	jù	câu
困难	kùnnán	khó khăn
警察	jǐngchá	cảnh sát
到处	dàochù	khắp nơi
感动	gǎndòng	cảm động
十字路口	shízì lùkǒu	ngã tư đường
对	duì	đối
夫妻	fūqī	vợ chồng
看样子	kàn yàngzi	xem dáng vẻ, hình như
样子	yàngzi	hình dáng, kiểu
农村	nóngcūn	nông thôn
来往	láiwǎng	qua lại
敢	gǎn	dám
立即	lìjí	ngay, lập tức
扶	fú	đỡ, hỗ trợ
情景	qíngjǐng	tình cảnh
可	kě	khả
发生	fāshēng	xảy ra, phát sinh
滚	gǔn	lăn
抱	bào	bế, ôm
鞋带	xiédài	dây giày
鞋	xié	giày
脚	jiǎo	chân
伸	shēn	duỗi ra
面前	miànqián	trước mặt
叔叔	shūshu	chú
弯	wān	khom, cong
腰	yāo	lưng
梅	méi	cây mai
画	huà	bức tranh, vẽ
画家	huàjiā	họa gia
松	sōng	cây tùng
竹	zhú	tre
骄傲	jiāo'ào	kiêu ngạo
岁寒三友	suì hán sān yǒu	ba người bạn mùa đông
字画	zìhuà	tranh chữ
过奖	guòjiǎng	quá khen
朴正浩	Piáo Zhènghào	Park Jungho
电台	diàntái	đài
邀请	yāoqǐng	mời
呆	dāi	ở lại, lưu lại
签	qiān	ký
合同	hétóng	hợp đồng
中外	zhōng-wài	Trung Quốc và nước ngoài
合资	hézī	hợp tác đầu tư
空儿	kòngr	thời gian trống
地址	dìzhǐ	địa chỉ
业务	yèwù	nghiệp vụ
搞	gǎo	làm
交流	jiāoliú	giao lưu
成立	chénglì	thành lập
不久	bùjiǔ	không lâu
开展	kāizhǎn	mở ra, triển khai
继续	jìxù	tiếp tục
数字	shùzi	chữ số, con số
连…也…	lián…yě…	ngay cả…cũng…
简单	jiǎndān	đơn giản, dễ
一半	yībàn	một nửa
中国通	zhōngguótōng	người am hiểu về Trung Quốc
通	tōng	am hiểu, thông thạo
少	shào	trẻ tuổi
别人	biérén	người khác, người ta
伟大	wěidà	to lớn, vĩ đại
可	kě	biểu thị nhấn mạnh
申请	shēnqǐng	xin
专利	zhuānlì	bằng quyền
认为	rènwéi	cho rằng
吉利	jílì	tốt lành và thuận lợi
音	yīn	âm thanh
笨	bèn	đần, ngu ngốc
谐音	xiéyīn	hài âm
巧克力	qiǎokèlì	sô-cô-la
土豆	tǔdòu	khoai tây
胡说	húshuō	nói liều, nói bừa
友谊	yǒuyì	tình hữu nghĩ, tình bạn
长久	chángjiǔ	lâu dài
爱情	àiqíng	tình yêu, ái tình
活	huó	sống
顺	shùn	thuận lợi, thuận
宴会	yànhuì	tiệc, bữa tiệc
规矩	guīju	nền nếp, phép tắc
首先	shǒuxiān	đầu tiên
重要	zhòngyào	quan trọng, trọng yếu
领导	lǐngdǎo	lãnh đạo
长辈	zhǎngbèi	bề trên, bậc trên
上座	shàngzuò	chỗ ngồi cao quý nhất
敬酒	jìngjiǔ	kính
上菜	shàngcài	dọn món ăn ra
如果	rúguǒ	nếu như
上次	shàngcì	lần trước
下次	xiàcì	lần sau
干杯	gānbēi	cạn ly, nâng ly
代替	dàitì	thay thế, thay
当	dāng	làm, thay cho
哈哈	hāhā	ha ha, khả khả
吹	chuī	thổi, thổi phồng
戴面具	【Dài miànjù】	Đeo mặt nạ
武功	【wǔgōng】	võ công
旗袍	【qípáo】	sườn xám, xường xám
发脾气	【fā píqì】	phát cáu, nổi giận, tức giận, mất bình tĩnh
怒气	【nùqì】	cơn giận dữ, cơn thịnh nộ, vẻ giận dữ, nộ khí, nư
贪婪	【tānlán】	tham lam
自私	【zìsī】	ích kỷ
合约	【héyuē】	hợp đồng, giao kèo
合同	【hétong】	hợp đồng, giao kèo
相反	【xiāngfǎn】	tương phản, đối lập, trái ngược nhau
悄悄	【qiāoqiāo】	lặng lẽ, khe khẽ, nhẹ nhàng
聚会	【jùhuì】	tụ tập, tụ họp, gặp gỡ
反应	【fǎnyìng】	phản ứng
公告	gōng gào	thông báo, công bố
开心	kāi xīn	vui vẻ
阿弥陀佛	ē mí tuó fó	A Di Đà Phật
邀请	yāo qǐng	mời
邀请函	yāo qǐng hán	thư mời
邀请赛	yāo qǐng sài	giải đấu mời
原则	yuán zé	nguyên tắc
婚礼	hūn lǐ	đám cưới
国际机场	guó jì jī chǎng	sân bay quốc tế
广播	guǎng bò	phát thanh, phát sóng
电台	diàn tái	đài phát thanh
广播电台	guǎng bò diàn tái	đài phát thanh
海南	hǎi nán	Hải Nam
合作	hé zuò	hợp tác
合同	hé tóng	hợp đồng
公司	gōng sī	công ty
合约	hé yuē	hợp đồng
文化	wén huà	văn hóa
停电	tíng diàn	mất điện
眼镜	yǎn jìng	kính mắt
突然	tū rán	đột nhiên
事故	shì gù	tai nạn
决定	jué dìng	quyết định
变化	biàn huà	thay đổi
脸书	liǎn shū	Facebook
照片	zhào piàn	ảnh, bức ảnh
名字	míng zì	tên
意外	yì wài	bất ngờ, ngoài ý muốn
危险	wēi xiǎn	nguy hiểm
绑起来	bǎng qǐ lái	buộc lại
收起来	shōu qǐ lái	thu dọn lại
画出来	huà chū lái	vẽ ra
洗出来	xǐ chū lái	rửa ra
坚持	jiān chí	kiên trì
按时	àn shí	đúng giờ
解决	jiě jué	giải quyết
心心	xīn xīn	tâm tư, lòng dạ
产假	chǎn jià	nghỉ thai sản
产生	chǎn shēng	sản sinh, phát sinh
障	zhàng	chướng ngại, cản trở
开除	kāi chú	đuổi việc, khai trừ
结果	jié guǒ	kết quả
解雇	jiě gù	sa thải
辞退	cí tuì	sa thải, từ chối
辞职	cí zhí	từ chức
炒鱿鱼	chǎo yóu yú	bị sa thải
直播	zhí bō	livestream, phát trực tiếp
民族	mín zú	dân tộc
少数民族	shǎo shù mín zú	dân tộc thiểu số
调查	diào chá	điều tra
考察	kǎo chá	khảo sát
调整	tiáo zhěng	điều chỉnh
路线	lù xiàn	tuyến đường, lộ trình
外地	wài dì	ngoại tỉnh, nơi khác
饥饿	jī è	đói khát
保险	bǎo xiǎn	bảo hiểm
锻炼	duàn liàn	rèn luyện, tập thể dục
刷牙	shuā yá	đánh răng
换衣服	huàn yī fú	thay quần áo
见面	jiàn miàn	gặp mặt
说话	shuō huà	nói chuyện
事情	shì qíng	sự việc, chuyện
北京烤鸭	běi jīng kǎo yā	vịt quay Bắc Kinh
从来	cóng lái	từ trước đến nay
购买	gòu mǎi	mua sắm
眼镜	yǎn jìng	kính mắt
错	cuò	sai, lỗi
遇到	yù dào	gặp phải